-10
12
0
7
00000000000000000000000
00000000000000000000000
11111110000000011111110
11111110000000011111110
11111110001111011111110
11111110001111011111110
11111110000000011111110
00000000000000000000000
